11111111111111111111111111111
1E0000000100000C00010C0000001
10100101001000001010010100001
1010110010101011001001000C001
1P00000C0C00C00000000000000C1
11111111111111111111111111111