11111111111111111111111111111111111111111111
1E0000000000000C000C011010010100100000101001
1010P101001000001010011010010100100000101001
10100101001000001010011010010100100000101001
10100100101010100010011010010100100000101001
100000000C00C0000000011010010100100000101001
11111111111111111111111111111111111111111111
1E0000000000000C000C011010010100100000101001
10100101001000001010011010010100100000101001
10100100101010100010011010010100100000101001
100000000C00C0000000011010010100100000101001
11111111111111111111111111111111111111111111
1E0000000000000C000C011010010100100000101001
10100101001000001010011010010100100000101001
10100100101010100010011010010100100000101001
100000000C00C0000000011010010100100000101001
11111111111111111111111111111111111111111111