1111111111
1E000C00C1
1111111111